#############
###   #   ###
##    #    ##
#           #
#           #
#           #
###       ###
#           #
#           #
#           #
##    #    ##
###   #   ###
#############