##########
#        #
#        #
#        #
#        #
#        #
#        #
#   ##   #
#   ##   #
##########